확실하네요	두달째 복용중 입니다~ 먹기전후가 확실히 차이가 납니다~ 아침에 피곤함이 덜하고~ 한번에 기상~^^ 꾸준히 복용 예정 입니다
확실히 덜 피곤한거 같아요	신랑이 좋다네요~~~피곤해했는데 먹고나서 덜피곤해해요!!!
빠른배송에 전반적 만족	배송은 무지 빠릅니다 일단 후기가 좋아서 구매했어요 먹고 효과 좋으면 장복할려구요
선물용으로 구매했어요 만족합니다	선물해줬는데 받은 분이 만족해하시네요 먹기도 편하고 피로회복에도 도움 된다고 하네요
아버지 선물용으로 구입	아버지 보내드렸습니다~ 배송 빨랐고,,드시고 효과 있으면 좋겠습니다~~
만족	배송빠르고 포장깔끔
좀더 먹고	음.. 확실히 피곤한게 좀 덜한거 같은 느낌인데 정확히는 모르겠어요 마저 다 먹어봐야지
배송은 좋습니다	저렴하게 빨리 잘 받았어요~ 효과 있음 좋겠네요
운동할때 확실히 좋아요	후기가 좋아서 운동 전 섭취 용으로 산 제품인데 만족해서 재구매 예정입니다!
남편용	남편사줬더니 좋다고 하드라고요~
만족해용	2세 준비중인데 마카가 좋다기에 신랑주려고 샀어요 ~! 한달뒤 후기도올려볼게요 많이 파세요 ~!
배송완료	요즘 마카가 유행이여서 사봤어요 피로회복에 좋다고해서 엄청 기대됩니다
좋습니다	먹고 안 먹고 차이가 확 느껴져서 다시 재구매해서 먹을꺼예요 체력이 좋아진 느낌? 확 드네요 ~
굿	피곤이 사라진 느낌? 이제 느낌이 현실이 됨을 증명하길^^
감사합니다	요즘 몸이 피로감이 심해서  광고 보고  좋아질까봐  그매했는데  일단 복용해봐야겠네요~
잘 도착 했어요	기존 블랙마카 제품 복용자인데 성분이 더 좋은듯해서 바꿔봤어요~~
배송완료	남친이 출장이 많아서 계속 피곤하고해서 주문.효과가있으면 좋겠어요
좋아요	임신 준비 중이라서 남편을 위해 샀습니다~남편이 잘 먹고있습니다
만족해요	아직은 모르겠는데 성분이 맘에들어서 구매했습니다~~ 먹고 좋으면 재구매 의사 있습니다
블랙마카	배송 무지 빠르고 일단 맞을지 몰라서 한 통만 구매했어요.
재구매	한 달 동안 먹구 재구매 했습니다!! 아침에 일어나는게 수월해진거 같고 덜 피곤한 것 같아요
안먹은거 보다는 좋아요	몬가 몬가가 좋아진거같기도 하고 안먹은날하고 뭔가 다른거 같기도 하고 플라시보효과같기도하고 뭔가 뭔가에여
헬스용	먹고 난뒤 피로감이 덜하니 좋아요 근력운동할때도 도움이 되어요
아주 만족해요	2틀째 섭취중인데 기력회복및 보충에 넘좋아요 주기적으로 계속 섭취해야겠어요
좋습니다	생활에 활력을 갖고싶어서 구매했어요 남편하고 같이먹고있어요 효과있길바래봅니다
피로회복	여러번 구매해서 복용중인데요,, 하루에 두번씩 나누어 먹지만 위에 부담도  없고 알(정)크기도 적당합니다.... 그리고 무엇보다 피로회복에 도움이 되는 것  같아요......
좋습니다	2번째 재구매인데.. 피로감이 사라짐니다 지속 복용 예정이에요.
굿굿	구우우우웃자아아나나압